SPACE PORT
+------------+               +-------------------+
|            |               |                   |
|            |               |                   |
|            |               |                   |
|            |               |                   |
|            |               |                   |
|            |               |                   |
|            |               |                   |
|            |               |                   |
+-----+      |               |                   |
      +-+  +-+               |                   |
                             |                   |
                             |                   |
  0                          |                   |
                             |                   |
      +-+  +-+               |                   |
+-----+      |               |                   |
|            |               |                   |
|            |               |                   |
|            |               +    +--------------+
|            |                                    
|            |                                    
|            |                                    
|            |                                    
|            |                                    
+------------+                                    
                                                  
                                                  
                                                  
                                                  
                                                  
                                   +-------+      
                                   |       |      
                                   |       |      
                                   |       |      
+-----------+-------+        +-----+       |      
|                   |        |             |      
|                                          |      
|                                          |      
|                   |        |             |      
|           +-------+        +-----+-------+      
|           |                                     
|           |                                     
|           |                                     
|           |                    +-----+          
|           |                    |-----|          
|           |                    |-----|          
|           |                    +-----+          
|           |                                     
+-----------+                                     