ABANDONED SHIP
+---+------------------------------------+-------+
|   |                                    |       |
| 0 |                                    |     = |
|   |                                    |       |
| = |                                    |   +---+
|   |                                    |   |   |
|   |                                    |   | ♥ |
|   |                                    |   |   |
|   |                                    |   +-%-+
|   |                                    |   |   |
|   |                                    |   |   |
|   |                                    |   |   |
|   |                                    |   |   |
|   |                                    |   |   |
|   |                                    |   |   |
|   |                                    |   |   |
|   |                                    |   |   |
|   |                                    |   |   |
|   |                                    |   |   |
|   |                                    |   |   |
|   |                                    |   +   |
|   |                                    |       |
|   |                                    |       |
|   |                                    |       |
|   |                                   /+---+   |
|   |                                  /     |   |
|   |                                 /      |   |
|   |                                        |   |
|   +   +--------------+                     |   |
|   |   |                          /         |   |
|   |   |                         /          |   |
|   |   |                        /           |   |
|   |   |              +--------+            |   |
|   |   |     +        |        |            |   |
|   |   |     |        | =      |            |   |
|   |   |     |        |        |            |   |
|   |   |     |        |        |            |   |
|   |   |     |        |        |            |   |
|   |   |     |        |        |            |   |
|   |   |     |        |        |            |   |
|   |   |     |        |        |            |   |
|   |   +     |        |        |            |   |
|   |         |        |        +            |   |
|   |         |        |                     |   |
|   |         |        |                     |   |
|   +---------+        +---------------------+   |
|                                                |
|                                                |
|                                                |
+---+--------------------------------------------+